1111111111
00000F0000
1111111110
00000P0000
1111111111