11111111111
00000000000
00000P00000
00000000000
00000000000
00000F00000
11111111111

